[6,7]
(4,3)
(2,1) | (0,1) | (1,1)
(6,0,1,1)
(6,1,1,1)
(6,2,1,1)
(6,3,1,1)
(6,4,1,1)
(6,5,1,1)