[8,10]
(4,2)
(1,4) | (4,4)
(7,1,1,1)
(7,3,1,1)
(7,5,1,1)
(7,6,1,1)
(3,6,1,1)